absorb	TRUE
acid	TRUE
acid_armor	FALSE
agility	FALSE
amnesia	FALSE
aurora_beam	TRUE
barrage	TRUE
barrier	FALSE
bide	FALSE
bind	TRUE
bite	TRUE
blizzard	TRUE
body_slam	TRUE
bone_club	TRUE
bonemerang	TRUE
bubble	TRUE
bubble_beam	TRUE
clamp	TRUE
comet_punch	TRUE
confuse_ray	FALSE
confusion	TRUE
constrict	TRUE
conversion	FALSE
counter	FALSE
crabhammer	TRUE
cut	TRUE
defense_curl	FALSE
dig	TRUE
disable	FALSE
dizzy_punch	TRUE
double_kick	TRUE
double_slap	TRUE
double_team	FALSE
double-edge	TRUE
dragon_rage	FALSE
dream_eater	TRUE
drill_peck	TRUE
earthquake	TRUE
egg_bomb	TRUE
ember	TRUE
explosion	TRUE
fire_blast	TRUE
fire_punch	TRUE
fire_spin	TRUE
fissure	FALSE
flamethrower	TRUE
flash	FALSE
fly	TRUE
focus_energy	FALSE
fury_attack	TRUE
fury_swipes	TRUE
glare	FALSE
growl	FALSE
growth	FALSE
guillotine	FALSE
gust	TRUE
harden	FALSE
haze	FALSE
headbutt	TRUE
high_jump_kick	TRUE
horn_attack	TRUE
horn_drill	FALSE
hydro_pump	TRUE
hyper_beam	TRUE
hyper_fang	TRUE
hypnosis	FALSE
ice_beam	TRUE
ice_punch	TRUE
jump_kick	TRUE
karate_chop	TRUE
kinesis	FALSE
leech_life	TRUE
leech_seed	FALSE
leer	FALSE
lick	TRUE
light_screen	FALSE
lovely_kiss	FALSE
low_kick	TRUE
meditate	FALSE
mega_drain	TRUE
mega_kick	TRUE
mega_punch	TRUE
metronome	FALSE
mimic	FALSE
minimize	FALSE
mirror_move	FALSE
mist	FALSE
night_shade	TRUE
pay_day	TRUE
peck	TRUE
petal_dance	TRUE
pin_missile	TRUE
poison_gas	FALSE
poison_powder	FALSE
poison_sting	TRUE
pound	TRUE
psybeam	TRUE
psychic	TRUE
psywave	FALSE
quick_attack	TRUE
rage	TRUE
razor_leaf	TRUE
razor_wind	TRUE
recover	FALSE
reflect	FALSE
rest	FALSE
roar	FALSE
rock_slide	TRUE
rock_throw	TRUE
rolling_kick	TRUE
sand_attack	FALSE
scratch	TRUE
screech	FALSE
seismic_toss	FALSE
self-destruct	TRUE
sharpen	FALSE
sing	FALSE
skull_bash	TRUE
sky_attack	TRUE
slam	TRUE
slash	TRUE
sleep_powder	FALSE
sludge	TRUE
smog	TRUE
smokescreen	FALSE
soft-boiled	FALSE
solar_beam	TRUE
sonic_boom	FALSE
spike_cannon	TRUE
splash	FALSE
spore	FALSE
stomp	TRUE
strength	TRUE
string_shot	FALSE
struggle	TRUE
stun_spore	FALSE
submission	TRUE
substitute	FALSE
super_fang	FALSE
supersonic	FALSE
surf	TRUE
swift	TRUE
swords_dance	FALSE
tackle	TRUE
tail_whip	FALSE
take_down	TRUE
teleport	FALSE
thrash	TRUE
thunder	TRUE
thunder_punch	TRUE
thunder_shock	TRUE
thunder_wave	FALSE
thunderbolt	TRUE
toxic	FALSE
transform	FALSE
tri_attack	TRUE
twineedle	TRUE
vice_grip	TRUE
vine_whip	TRUE
water_gun	TRUE
waterfall	TRUE
whirlwind	FALSE
wing_attack	TRUE
withdraw	FALSE
wrap	TRUE